00000000000000000000000000000000
00000000000000000000000000000000
00001111111111111111111111110000
00001111111111111111111111110000
00000000112222222222221100000000
00000000112222222222221100000000
00000011112233333333221111000000
00000011112233333333221111000000
00001111112233444433221111110000
00111111112233455433221111111111
00111111112233455433221111111111
00001111112233444433221111110000
00000011112233333333221111000000
00000011112233333333221111000000
00000000112222222222221100000000
00000000112222222222221100000000
00001111111111111111111111110000
00001111111111111111111111110000
00000000000000000000000000000000